0 1 2 3 2 3 2 3 2 3 2 4 0 0 0 0 0 1 2 3 2 3 2 3 2 3 2 4 0 0 0 0 0 0 0 0 0 0 0 5 6 7 8 9 8 10 11 12 
13 14 13 14 13 14 13 14 13 14 13 15 0 0 0 16 13 14 13 14 13 14 13 14 13 14 13 15 0 0 0 0 0 0 0 0 0 0 0 17 12 18 19 20 19 21 22 12 
23 24 23 24 23 24 23 24 23 24 23 25 2 3 2 26 23 24 23 24 23 24 23 24 23 24 23 25 2 3 2 3 2 3 2 3 2 3 2 27 28 29 30 31 30 32 33 12 
13 34 35 36 13 14 13 14 13 14 13 14 13 14 13 14 13 34 35 36 13 14 13 14 13 14 13 14 13 14 13 14 13 14 13 34 35 37 35 38 18 39 40 41 19 42 43 12 
23 44 45 46 23 24 23 24 23 24 23 24 23 24 23 24 23 44 45 46 23 24 23 24 23 24 23 24 23 24 23 24 23 24 23 44 45 47 45 12 48 49 50 51 30 52 11 12 
35 38 12 53 35 37 35 37 35 37 35 37 35 37 35 37 35 38 12 53 35 37 35 37 35 37 35 37 35 37 35 37 35 37 35 38 12 12 12 12 18 54 43 18 19 21 22 12 
45 55 56 47 45 47 45 47 45 47 45 47 45 47 45 47 45 55 56 47 45 47 45 47 45 47 45 47 45 47 45 47 45 47 45 55 56 12 12 12 48 52 11 51 30 32 33 12 
57 58 59 12 12 60 57 60 57 12 12 60 57 12 12 60 57 58 59 12 12 60 57 60 57 12 12 60 57 12 12 12 12 12 12 58 59 12 12 12 48 61 62 48 63 64 22 12 
65 66 67 68 69 70 65 71 65 72 69 70 65 72 69 70 65 66 67 68 69 70 65 71 65 72 69 70 65 72 69 69 69 73 74 75 67 76 77 78 79 80 81 82 83 84 33 12 
12 12 12 12 12 12 12 12 12 12 12 12 12 12 12 12 12 12 12 12 12 12 12 12 12 12 12 12 12 12 12 12 12 12 12 12 12 12 12 12 12 12 12 12 12 12 12 12 
